NO textures/north.xpm
SO textures/south.xpm
WE textures/west.xpm
EA textures/east.xpm

F 250,251,102
C 102,35,109


111111111111111111111111111111111111111
100000000000000000101111000000111111111
100000000000000000000000001011110000001
100001000000000000000000001011110000001
101001000000000000000000000000000000001
100001000010000000000000000000000000001
1010010000000000S0000000000000000000001
101001000000000000000000000000000000001
101001000000000000000000000000000000001
101001000000000000000000000000000000001
101001000000000000000000000000000000001
100001000000000000101111000000111111111
100001000000000000000000001011110000001
100001000000000000000000001011110000001
101001000000000000000000000000000000001
100001000010000000000000000000000000001
111111111111111111111111111111111111111