11111111111111111111111111111111111111
1001000010S010001011101000010001000101
10100000000011000011110000000000000001
10000000000000000000110000000000000001
10100011111000000000100000000000000011
10000000000000000000100000000000000011
10100000000000000000100000000000000011
10011100000000000000100000000000000011
10100000000000000000000000000000000011
10000000000000000000100000000000000011
10000000000000000000100000000000000011
10010000000000001000100000000000000001
11111111111111111111111111111111111111
